          NO textures/test/north.xpm
    SO textures/test/north.xpm
WE textures/test/north.xpm
EA textures/test/north.xpm

F 164,169,20
C 153,204,255 

1111111111111111111111111111111111
1000000000000000000000000000000101
1000000000000000000000000000000101
1000000000000000000000000000000101
1000000000000000000000000000000101
1000000000000000000000000000000101
1000000000000000000000000000000101
1000000000000000000000000000000101
1000000000000000000000000000000101
1000000000000000000000000000000101
1000000000000000000000000000000101
1000000000000000000000000000000101
1000000000000000000000000000000101
100000000000000N000000000000000101
1000000000000000000000000000000101
1000000000000000000000000000000101
1000000000000000000000000000000101
1000000000000000000000000000000101
1000000000000000000000000000000101
1000000000000000000000000000000101
1000000000000000000000000000000101
1000000000000000000000000000000101
1000000000000000000000000000000101
1000000000000000000000000000000101
1000000000000000000000000000000101
1000000000000000000000000000000101
1111111111111111111111111111111111
