NO ./textures/north.xpm
SO ./textures/south.xpm
WE ./textures/west.xpm
EA ./textures/east.xpm

F 220,100,0
C 225,30,0

1111111111111
10N0010000101
1101000101111
1111111101111
1111100000011
1001001000001
1111111111111