NO textures/simonkraft/wet_sponge.xpm
SO textures/simonkraft/wet_sponge.xpm
WE textures/simonkraft/wet_sponge.xpm
EA textures/simonkraft/wet_sponge.xpm

F 000000000000255,000,000
C 000000000000255,000000000000255,000000000000255

111111
1N0001
111111