NO textures/simonkraft/wet_sponge.xpm
SO textures/simonkraft/wet_sponge.xpm
WE textures/simonkraft/wet_sponge.xpm
EA textures/simonkraft/wet_sponge.xpm

F 0,0,0
C 0,0,0

1111111111
1N00011111
1111101111
111110111 1
    100001
    111111