NO textures/simonkraft/wet_sponge.xpm
SO textures/simonkraft/wet_sponge.xpm
WE textures/simonkraft/wet_sponge.xpm

F 0,0,0
C 0,0,0

111111
1N0001
111111

EA textures/simonkraft/wet_sponge.xpm
